SO textures/south.png
EA textures/east.png
WE textures/west.png
NO textures/north.png

F 220,100,0

C 255,255,255

11111111111111111111111111111111111111111
1000000000000000000000000000000000111111
11000000000000N0000000000000000000000111
11100000000000000000000000000000000000111111111111111111111
11100000000000000000000000000000000000111111111111111111111
111100000000000000000000000000000000000000000000000000111
11100000000000000000000000000000000000111111111111111111111111111
1111000000000000000000000000000001111111
111111111111111100000111111111111111111111111111
1111000000000000000000000000000001111111
1111000000000000000000000000000001111111
1111000000000000000000000000000001111111
1111000000000000000000000000000001111111
1111000000000000000000000000000001111111
1111000000000000000000000000000001111111
1111000000000000000000000000000001111111
1111000000000000000000000000000001111111
1111000000000000000000000000000001111111
1111000000000000000000000000000001111111
1111000000000000000000000000000001111111
11111111111111110000000011111111111111111111111111
1111111111111111111111111111111111111111111111