NO ./path_to_the_north_texture

SO ./path_to_the_south_texture

WE ./path_to_the_west_texture

EA ./path_to_the_east_texture
F 220,100,0

C 225,30,0


111111111111111111111111
100000000000000000000001
11111111110000000000000111111111111
          11100000000000000000000001
11111111110000000000000111111111111
11111111111111000001111111
1111111111000000000001111111
100000000000000000000001
100000000000000000000001
1000000000000000N00000001
1000000000000000000000111
111111111111111111111111

